--~--------
/        +|
#         |
|         #
-----------
