------#---------------#-~--
|                         |
|                         /
|                         |
\                         |
|                         |
|                         |
-------------##------------
