---##--------------------~-
|                         |
|                         #
/                         #
|                         |
|                         /
|                         |
#                         |
------------##-------#-----
