-~--##--------#-
|              |
|              |
|              /
|              |
----------------
